. . . . . . S
. . . . W W W
W W W . . . .
. . W W W . .
. . . . . . C
D . . . . . .
G . . . . . .